NO ./maps/test.xpm
SO ./maps/test.xpm
WE ./maps/test.xpm
EA ./maps/test.xpm

F 220,100,0
C 225,30,0


 11111111111111111111111111111111111111
1000000000000000000000000000000000000001
1000000000000000000000000000000000000001
1000000000000000000000000000000000000001
10000000000000000000000N0000000000000001
1000000000000000001010000000000000000001
1000000000000000001010000000000000000001
1000000000000000001N10010000000000000001
1000000000000000001110010000000000000001
1000000000000000000000000000000000000001
1000000000000000000000000000000000000001
1000000000000000000000000000000000000001
1000000000000000000000000000000000000001
1000000000000000000000000000000000000001
 11111111111111111111111111111111111111