NO ./maps/test.xpm
SO ./maps/test.xpm
WE ./maps/test.xpm
EA ./maps/test.xpm

F 220,100,0
C 225,30,0

111111   1111111111111111111
1000000000110000000000001
1011000001110000000000001
10010000      00000000000000001
111111111011000001110000000000001
100000000011000001110111111111111
11110111111111011100000010001
11110111111111011101010010001
11000000110101011100000010001
1000000000          0000001100000010001
10000000000000001101010010001
11000001110101011111011110N0111
111101111110101101111010001
111111111111111111111111111   